{
  "mapArray": [
    "**==================",
    "=******************=",
    "=***==***=***==****=",
    "=***==*=====*==****=",
    "=******************=",
    "=**=*****=******=**=",
    "=**=***=====****=**=",
    "=*==*=*******=**==*=",
    "=****=*******=*****=",
    "===**=*******=***===",
    "=******************=",
    "===**=***=***=***===",
    "=****==**=**==*****=",
    "=****=***=***=*****=",
    "=****=*=====*=*****=",
    "=******************=",
    "=*==*==**=***==*==*=",
    "=*==*==**=***==*==*=",
    "=********=*********=",
    "===================="
  ],
  "hero": {
    "x": 1,
    "y": 2,
    "view1": "⊕",
    "view2": "⊗",
    "nextStepDirection": "hold"
  },
  "enemiesArray": [
    {
      "x": 7,
      "y": 9,
      "view": "♕"
    },
    {
      "x": 9,
      "y": 10,
      "view": "♕"
    }
  ]
}
